'a	ぁ
a	あ
'i	ぃ
i	い
yi	い
ye	いぇ
'u	ぅ
u	う
wu	う
wha	うぁ
wi	うぃ
we	うぇ
who	うぉ
'e	ぇ
e	え
'o	ぉ
o	お
ka	か
ga	が
ki	き
gi	ぎ
kye	きぇ
gye	ぎぇ
kya	きゃ
gya	ぎゃ
kyu	きゅ
gyu	ぎゅ
kyo	きょ
gyo	ぎょ
ku	く
gu	ぐ
ke	け
ge	げ
ko	こ
go	ご
sa	さ
za	ざ
shi	し
si	し
ji	じ
zi	じ
she	しぇ
sye	しぇ
je	じぇ
zye	じぇ
sha	しゃ
sya	しゃ
ja	じゃ
zya	じゃ
shu	しゅ
syu	しゅ
ju	じゅ
zyu	じゅ
sho	しょ
syo	しょ
jo	じょ
zyo	じょ
su	す
zu	ず
se	せ
ze	ぜ
so	そ
zo	ぞ
ta	た
da	だ
chi	ち
ti	ち
di	ぢ
che	ちぇ
tye	ちぇ
cha	ちゃ
tya	ちゃ
chu	ちゅ
tyu	ちゅ
cho	ちょ
tyo	ちょ
'c	っ
tu	つ
du	づ
te	て
de	で
to	と
do	ど
na	な
ni	に
nye	にぇ
nya	にゃ
nyu	にゅ
nyo	にょ
nu	ぬ
ne	ね
no	の
ha	は
ba	ば
pa	ぱ
hi	ひ
bi	び
pi	ぴ
hye	ひぇ
bye	びぇ
pye	ぴぇ
hya	ひゃ
bya	びゃ
pya	ぴゃ
hyu	ひゅ
byu	びゅ
pyu	ぴゅ
hyo	ひょ
byo	びょ
pyo	ぴょ
fu	ふ
hu	ふ
bu	ぶ
pu	ぷ
fa	ふぁ
fi	ふぃ
fe	ふぇ
fo	ふぉ
he	へ
be	べ
pe	ぺ
ho	ほ
bo	ぼ
po	ぽ
ma	ま
mi	み
mye	みぇ
mya	みゃ
myu	みゅ
myo	みょ
mu	む
me	め
mo	も
'ya	ゃ
ya	や
'yu	ゅ
yu	ゆ
'yo	ょ
yo	よ
ra	ら
ri	り
rye	りぇ
rya	りゃ
ryu	りゅ
ryo	りょ
ru	る
re	れ
ro	ろ
wa	わ
wo	を
n	ん
nn	ん
-	ー
xi	き
kje	きぇ
gje	ぎぇ
qa	きゃ
gja	ぎゃ
qu	きゅ
gju	ぎゅ
qo	きょ
gjo	ぎょ
qe	け
ci	し
xe	しぇ
xa	しゃ
xu	しゅ
xo	しょ
ce	せ
qi	ち
ca	ちゃ
cu	ちゅ
co	ちょ
thi	てぃ
dhi	でぃ
thu	てゅ
dhu	でゅ
tho	とぅ
dho	どぅ
nje	にぇ
nja	にゃ
nju	にゅ
njo	にょ
hje	ひぇ
bje	びぇ
pje	ぴぇ
hja	ひゃ
bja	びゃ
pja	ぴゃ
hju	ひゅ
bju	びゅ
pju	ぴゅ
hjo	ひょ
bjo	びょ
pjo	ぴょ
fju	ふゅ
mje	みぇ
mja	みゃ
mju	みゅ
mjo	みょ
li	り
la	りゃ
lu	りゅ
lo	りょ
le	れ
:	ー
'b	っ	b
cc	っ	c
'd	っ	d
'f	っ	f
ff	っ	f
'g	っ	g
'h	っ	h
'j	っ	j
'k	っ	k
kk	っ	k
'l	っ	l
'm	っ	m
'n	っ	n
'p	っ	p
pp	っ	p
'q	っ	q
qq	っ	q
'r	っ	r
's	っ	s
ss	っ	s
tt	っ	t
'v	っ	v
'w	っ	w
'x	っ	x
xx	っ	x
'z	っ	z
"a	ァ
"i	ィ
"u	ゥ
vhu	ヴ
n,u	う゚
n.u	ウ゚
vha	ヴぁ
vhi	ヴぃ
vhe	ヴぇ
vho	ヴぉ
"e	ェ
"o	ォ
"ka	ヵ
'ka	ゕ
n,ga	か゚
n.ga	カ゚
n,gi	き゚
n.gi	キ゚
k-y	きぃ
g-y	ぎぃ
"ku	ㇰ
n,gu	く゚
n.gu	ク゚
k-a	くぁ
g-a	ぐぁ
k-i	くぃ
g-i	ぐぃ
k-u	くぅ
g-u	ぐぅ
k-e	くぇ
g-e	ぐぇ
k-o	くぉ
g-o	ぐぉ
k-w	くゎ
g-w	ぐゎ
"ke	ヶ
'ke	ゖ
n,ge	け゚
n.ge	ケ゚
n,go	こ゚
n.go	コ゚
"si	ㇱ
s-y	しぃ
z-y	じぃ
"su	ㇲ
s-a	すぁ
s-i	すぃ
s-u	すぅ
s-e	すぇ
s-o	すぉ
n.se	セ゚
t-y	ちぃ
d-y	ぢぃ
d-je	ぢぇ
d-ja	ぢゃ
d-ju	ぢゅ
d-jo	ぢょ
"tu	ッ
n.tu	ツ゚
c-a	つぁ
d-a	づぁ
c-i	つぃ
d-i	づぃ
c-u	つぅ
d-u	づぅ
c-e	つぇ
d-e	づぇ
c-o	つぉ
d-o	づぉ
t-hi	てぃ
d-hi	でぃ
t-he	てぇ
d-he	でぇ
t-ha	てゃ
d-ha	でゃ
t-hu	てゅ
d-hu	でゅ
t-ho	てょ
d-ho	でょ
"to	ㇳ
n.to	ト゚
t-a	とぁ
d-va	どぁ
t-i	とぃ
d-vi	どぃ
t-u	とぅ
d-vu	どぅ
t-e	とぇ
d-ve	どぇ
t-o	とぉ
d-vo	どぉ
n-yi	にぃ
"nu	ㇴ
"ha	ㇵ
"hi	ㇶ
h-yi	ひぃ
b-yi	びぃ
p-yi	ぴぃ
"hu	ㇷ
.pu	ㇷ゚
h-wa	ふぁ
h-wi	ふぃ
h-wu	ふぅ
h-we	ふぇ
h-wo	ふぉ
f-ya	ふゃ
f-yu	ふゅ
f-yo	ふょ
"he	ㇸ
"ho	ㇹ
m-yi	みぃ
"mu	ㇺ
"ya	ャ
"yu	ュ
"yo	ョ
"ra	ㇻ
"ri	ㇼ
r-yi	りぃ
"ru	ㇽ
"re	ㇾ
"ro	ㇿ
"wa	ヮ
'wa	ゎ
wyi	ゐ
wye	ゑ
vn	あん
yd	いぇん
vg	いん
whn	うぁん
vhn	ヴぁん
whg	うぃん
vhg	ヴぃん
whd	うぇん
vhd	ヴぇん
whp	うぉん
vhp	ヴぉん
vb	うん
vvb	ヴん
vd	えん
vp	おん
kn	かん
gn	がん
qn	きゃん
gjn	ぎゃん
qb	きゅん
gjb	ぎゅん
qp	きょん
gjp	ぎょん
kg	きん
gg	ぎん
kb	くん
gb	ぐん
kd	けん
gd	げん
kp	こん
gp	ごん
sn	さん
zn	ざん
sjd	しぇん
jd	じぇん
xg	しゃん
jn	じゃん
xb	しゅん
jb	じゅん
xp	しょん
jp	じょん
sg	しん
jg	じん
zg	じん
sb	すん
zb	ずん
sd	せん
zd	ぜん
sp	そん
zp	ぞん
tn	たん
dn	だん
cjn	ちぇん
cn	ちゃん
cb	ちゅん
cp	ちょん
qg	ちん
tb	つん
tg	てぃん
dg	でぃん
td	てん
dd	でん
tp	とん
dp	どん
nm	なん
njn	にゃん
njb	にゅん
njp	にょん
ng	にん
nb	ぬん
nd	ねん
np	のん
hn	はん
bn	ばん
pn	ぱん
hjb	ひゅん
bjb	びゅん
pjb	ぴゅん
hjp	ひょん
bjp	びょん
pjp	ぴょん
hg	ひん
bg	びん
pg	ぴん
fn	ふぁん
fg	ふぃん
fd	ふぇん
fp	ふぉん
fb	ふん
bb	ぶん
pb	ぷん
hd	へん
bd	べん
pd	ぺん
hp	ほん
bp	ぼん
pm	ぽん
mn	まん
mjn	みゃん
mjb	みゅん
mjp	みょん
mg	みん
mb	むん
md	めん
mp	もん
yn	やん
yb	ゆん
yp	よん
rn	らん
ln	りゃん
lp	りょん
lg	りん
rb	るん
ld	れん
rp	ろん
wn	わん
vf	あい
vhf	ヴぁい
vhy	ヴぉい
vl	えい
vv	おう
kf	かい
gf	がい
qy	きい
qv	きゅう
gjv	ぎゅう
qw	きょう
gjw	ぎょう
kv	くう
gw	ぐう
kl	けい
gl	げい
kw	こう
gv	ごう
sf	さい
zf	ざい
cy	しい
jy	じい
xl	しぇい
jl	じぇい
xf	しゃい
jf	じゃい
xv	しゅう
jv	じゅう
xw	しょう
jw	じょう
sj	すい
zj	ずい
sv	すう
zv	ずう
sl	せい
zl	ぜい
sw	そう
zw	ぞう
tf	たい
df	だい
cl	ちぇい
cf	ちゃい
cv	ちゅう
cw	ちょう
tj	つい
tv	つう
tl	てい
dl	でい
tw	とう
dw	どう
nf	ない
nji	にい
njv	にゅう
njw	にょう
nw	ぬう
nl	ねい
nv	のう
hf	はい
bf	ばい
pf	ぱい
hji	ひい
bji	びい
pji	ぴい
hjv	ひゅう
vw	びゅー
bjv	びゅう
pjv	ぴゅう
hjw	ひょう
bjw	びょう
pjw	ぴょう
fy	ふぁい
hv	ふう
bv	ぶう
pv	ぷう
fl	ふぇい
fv	ふぉー
fw	ふゅー
hl	へい
bl	べい
pl	ぺい
hw	ほう
bw	ぼう
pw	ぽう
mf	まい
mji	みい
mjv	みゅう
mjw	みょう
mv	むう
ml	めい
mw	もう
yf	やい
yv	ゆう
yw	よう
rf	らい
ly	りい
lv	りゅう
lw	りょう
lj	るい
rv	るう
ll	れい
rw	ろう
wf	わい
;a	あー
;i	いー
w;i	うぃー
;u	うー
w;e	うぇー
w;o	うぉー
;e	えー
;o	おー
k;a	かー
g;a	がー
k;i	きー
x;i	きー
g;i	ぎー
q;a	きゃー
gj;a	ぎゃー
q;u	きゅー
gj;u	ぎゅう
q;o	きょー
gj;o	ぎょー
k;u	くー
g;u	ぐー
k;e	けー
g;e	げー
k;o	こー
g;o	ごー
s;a	さー
z;a	ざー
c;i	しー
s;i	しー
j;i	じー
z;i	じー
x;e	しぇー
j;e	じぇー
x;a	しゃー
j;a	じゃー
x;u	しゅー
j;u	じゅー
x;o	しょー
j;o	じょー
s;u	すー
z;u	ずー
s;e	せー
z;e	ぜー
s;o	そー
z;o	ぞー
t;a	たー
d;a	だー
q;i	ちー
c;e	ちぇー
c;a	ちゃー
c;u	ちゅー
c;o	ちょー
t;i	てぃー
d;i	でぃー
t;e	てー
d;e	でー
t;u	とぅー
d;u	どぅー
t;o	とー
d;o	どー
n;a	なー
n;i	にー
nj;a	にゃー
nj;u	にゅー
nj;o	にょー
n;u	ぬー
n;e	ねー
n;o	のー
h;a	はー
b;a	ばー
p;a	ぱー
h;i	ひー
b;i	びー
p;i	ぴー
hj;a	ひゃー
bj;a	びゃー
pj;a	ぴゃー
hj;u	ひゅー
bj;u	びゅー
pj;u	ぴゅー
hj;o	ひょー
bj;o	びょー
pj;o	ぴょー
f;a	ふぁー
f;i	ふぃー
f;u	ふー
h;u	ふー
b;u	ぶー
p;u	ぷー
f;e	ふぇー
f;o	ふぉー
h;e	へー
b;e	べー
p;e	ぺー
h;o	ほー
b;o	ぼー
p;o	ぽー
m;a	まー
m;i	みー
mj;a	みゃー
mj;u	みゅー
mj;o	みょー
m;u	むー
m;e	めー
m;o	もー
y;a	やー
y;u	ゆー
y;o	よー
r;a	らー
l;i	りー
r;i	りー
l;a	りゃー
l;u	りゅー
l;o	りょー
r;u	るー
r;e	れー
r;o	ろー
w;a	わー
vq	あく
vt	あつ
yk	いく
yz	いつ
ws	うつ
yx	えき
ys	えつ
wc	おく
wz	おつ
kq	かく
gq	がく
kt	かつ
gt	がつ
qz	きつ
kjq	きゃく
gjq	ぎゃく
qc	きょく
gjc	ぎょく
ks	くつ
gx	げき
qs	けつ
gs	げつ
kc	こく
gc	ごく
kz	こつ
sq	さく
st	さつ
zt	ざつ
cx	しき
jx	じき
cz	しつ
jz	じつ
xq	しゃく
jq	じゃく
xk	しゅく
jjk	じゅく
xs	しゅつ
js	じゅつ
xc	しょく
sx	せき
zx	ぜき
cs	せつ
zs	ぜつ
sc	そく
zc	ぞく
xz	そつ
tq	たく
dq	だく
thh	たち
dhh	だち
tht	たつ
dt	だつ
qk	ちく
cq	ちゃく
ck	ちょく
tx	てき
ts	てつ
tc	とく
dc	どく
dz	とつ
nt	なつ
njq	にゃく
hq	はく
bq	ばく
pq	ぱく
ht	はつ
bt	ばつ
pt	ぱつ
hz	ひつ
hjq	ひゃく
bjq	びゃく
fk	ふく
fs	ふつ
bs	ぶつ
hx	へき
vx	べき
vz	べつ
hc	ほく
bc	ぼく
pc	ぽく
bz	ぼつ
mq	まく
mt	まつ
mjz	みつ
mjq	みゃく
mjs	めつ
mc	もく
mz	もつ
yq	やく
yc	よく
rq	らく
rt	らつ
rjx	りき
lk	りく
lz	りつ
lq	りゃく
lc	りょく
lx	れき
ls	れつ
rc	ろく
wq	わく
thx	ありがとう
yjb	いえば
smxt	そして
drk	だけ
tml	とおり
nrgr	ながら
nrd	など
hs	はず
hmd	ほど
mrz	まず
mrt	また
mrd	まだ
mhd	まで
mrr	まる
mmx	もし
k	か
g	が
x	き
q	く
c	こ
d	で
t	と
j	に
s	の
f	は
h	へ
m	も
y	や
r	る
w	を
kr	から
mxw	ましょう
mxwk	ましょうか
mxwg	ましょうが
mx	まし
mxt	ました
mxtk	ましたか
mxtg	ましたが
mxtr	ましたら
mxd	まして
mxdf	ましては
ms	ませ
msd	ません
msnk	ませんか
msng	ませんが
ms;	ます
msk	ますか
msg	ますが
msn	ますの
msnf	ますのは
msnd	ますので
mst	ますと
dxw	でしょう
dxwk	でしょうか
dxwg	でしょうが
dx	でし
dxt	でした
dxtk	でしたか
dxtg	でしたが
dxd	でして
dxdf	でしては
ds;	です
dsk	ですか
dsg	ですが
dsn	ですの
dsnf	ですのは
dsnd	ですので
dst	ですと
rr	あら
rj	あり
r't	あった
r'tk	あったか
r'tg	あったが
r'tr	あったら
r'd	あって
r'df	あっては
r'dm	あっても
r;	ある
rrk	あるか
rrkt	あるかと
rrg	あるが
rrn	あるの
rrnd	あるので
rrnf	あるのは
rrndf	あるのでは
rrt	あると
rrtf	あるとは
rl	あれ
rlb	あれば
nrz	ならず
nrzn	ならずに
nrj	なり
nr't	なった
nr'tk	なったか
nr'tg	なったが
nr'tt	なったと
nr'tnd	なったので
nr'd	なって
nr'dm	なっても
nr;	なる
nrk	なるか
nrkt	なるかと
nrg	なるが
nrt	なると
nrtf	なるとは
nrnd	なるので
nrl	なれ
nrlb	なれば
nrw	なろう
nrwt	なろうと
xm	し	m
xtr	したら
xtl	したり
xn	し	n
xnf	しない
xnfd	しないで
xnfdm	しないでも
xnft	しないと
xjw	しよう
xjwk	しようか
xjwkt	しようかと
xjwg	しようが
xjwt	しようと
xjwtm	しようとも
sz	せず
sr;	する
srk	するか
srg	するが
srn	するの
srnd	するので
srnf	するのは
srndf	するのでは
srnn	するのに
srt	すると
srtf	するとは
srl	すれ
srlb	すれば
xr	しろ
xt	した
xtk	したか
xtg	したが
xd	して
wm	い	m
wjf	いない
wjw	いよう
wt	いた
wjd	いて
w;	いる
wl	いれ
wlb	いれば
dk	でき
dkr	できる
dkt	できた
dkd	できて
dklb	できれば
drv	だろう
d't	だった
nhnd	なので
nr	なら
nrb	ならば
drw	であろう
drj	であり
dr't	であった
dr'd	であって
dr;	である
drl	であれ
drlb	であれば
t'rw	たろう
'tr	ったら
d'r	だら
tr	たら
trj	たり
tr;	たる
trl	たれ
jtk	につき
jtd	について
jrn	よらな
jrnf	よらない
jrz	よらず
jrj	より
j't	よった
j'd	よって
jr;	よる
jrlb	よれば
njrnf	によらない
njrz	によらず
njrj	により
nj't	によった
nj'd	によって
njr;	による
njlb	によれば
tmrb	とならば
tmrj	となり
tm't	となった
tm'd	となって
tmr;	となる
tmrl	となれ
tmrlb	となれば
nqrw	なかろう
nq't	なかった
nq	なく
nqt	なくて
nql	なけれ
nqlb	なければ
gzm;	ございます
gzmxt	ございました
gzmxd	ございまして
gzmsn	ございません
cd	くだ
lr	れる
rxj	らしい
rxk	らしく
khn	この
khm	こんな
khw	こう
khl	これ
khj	こいつ
khk	ここ
khr	こちら
khh	こっち
shn	その
shm	そんな
shl	それ
shj	そいつ
shk	そこ
shr	そちら
shh	そっち
;n	あの
k;n	かの
;hm	あんな
;ht	あなた
;l	あれ
k;l	かれ
;hj	あいつ
;hk	あそこ
;hr	あちら
;hh	あっち
dhn	どの
dhm	どんな
dht	どなた
dhl	どれ
d;l	だれ
dhj	どいつ
dhk	どこ
dhr	どちら
dhh	どっち
djj	いつ
djk	いか
djkj	いかに
djkn	いかん
ww	われ
wts	わたし
wtks	わたくし
jk	いく
jkj	いくつ
jkr	いくら
nj	なに
nz	なぜ
nzj	なぜに
thm	ため
thmn	ために
thmnf	ためには
tmx	とき
dmx	どき
tkr	ところ
tk	とこ
dmkr	どころ
ct	こと
gmt	ごと
ft	ひと
kht	かた
ght	がた
mm	もの
cr	ころ
gr	ごろ
sm	さま
zm	ざま
wk	わけ
sks	しかし
