a	あ
i	い
u	う
e	え
o	お
;	ー
'	っ
ka	か
ki	き
ku	く
ke	け
ko	こ
kn	かん
kz	かん
kg	きん
kk	っ	k
kb	くん
kp	くん
kd	けん
kt	こと
km	こん
kq	こん
kf	かい
kv	くう
kl	けい
ks	けい
kx	こう
kc	
kr	から
k;	これ
k'	
kja	きゃ
kji	き
kju	きゅ
kje	きぇ
kjo	きょ
kjn	きゃん
kjz	きゃん
kjg	きぃん
kjk	きぃん
kjb	きゅん
kjp	きゅん
kjd	きぇん
kjt	きぇん
kjm	きょん
kjq	きょん
kjf	きゃい
kjy	きゃい
kjw	きゅう
kjv	きゅう
kjl	きぇい
kjs	きぇい
kjh	きょう
kjx	きょう
kjc	
kjr	
kjj	
kj;	
kj'	
kya	きゃあ
kyi	きい
kyu	きゅう
kye	きぇい
kyo	きょう
kyn	きゃん
kyz	きゃん
kyg	きぃん
kyk	きぃん
kyb	きゅん
kyp	きゅん
kyd	きぇん
kyt	きぇん
kym	きょん
kyq	きょん
kyf	きゃい
kyy	きゃい
kyw	きゅう
kyv	きゅう
kyl	きぇい
kys	きぇい
kyh	きょう
kyx	きょう
kyc	
kyr	
kyj	
ky;	
ky'	
kha	かー
khi	きー
khu	くー
khe	けー
kho	こー
khn	
khz	
khg	
khk	
khb	
khp	
khd	
kht	
khm	
khq	
khf	
khy	
khw	
khv	
khl	
khs	
khh	
khx	
khc	
khr	
khj	
kh;	
kh'	
kwa	くぁ
kwi	くぃ
kwu	くぅ
kwe	くぇ
kwo	くぉ
kwn	くぁん
kwz	くぁん
kwg	くぃん
kwk	くぃん
kwb	くぅん
kwp	くぅん
kwd	くぇん
kwt	くぇん
kwm	くぉん
kwq	くぉん
kwf	くぁい
kwy	くぁい
kww	くぅう
kwv	くぅう
kwl	くぇい
kws	くぇい
kwh	くぉう
kwx	くぉう
kwc	
kwr	
kwj	
kw;	
kw'	
qa	きゃ
qi	き
qu	きゅ
qe	きぇ
qo	きょ
qn	きゃん
qz	きゃん
qg	きん
qk	きん
qb	きゅん
qp	きゅん
qd	きぇん
qt	きぇん
qm	きょん
qq	っ	q
qf	きゃい
qy	きゃい
qw	きゅう
qv	きゅう
ql	きぇい
qs	きぇい
qx	きょう
qc	
qr	
qj	
q;	
q'	
qha	きゃー
qhi	きー
qhu	きゅー
qhe	けー
qho	きょー
qhn	
qhz	
qhg	
qhk	
qhb	
qhp	
qhd	
qht	
qhm	
qhq	
qhf	
qhy	
qhw	
qhv	
qhl	
qhs	
qhh	
qhx	
qhc	
qhr	
qhj	
qh;	
qh'	
ga	が
gi	ぎ
gu	ぐ
ge	げ
go	ご
gn	がん
gz	がん
gg	っ	g
gk	ぎん
gb	ぐん
gp	ぐん
gd	げん
gt	げん
gm	ごん
gq	ごん
gf	がい
gv	がい
gl	げい
gs	げい
gx	ごう
gc	
gr	
g;	
g'	
gja	ぎゃ
gji	ぎ
gju	ぎゅ
gje	ぎぇ
gjo	ぎょ
gjn	ぎゃん
gjz	ぎゃん
gjg	ぎぃん
gjk	ぎぃん
gjb	ぎゅん
gjp	ぎゅん
gjd	ぎぇん
gjt	ぎぇん
gjm	ぎょん
gjq	ぎょん
gjf	ぎゃい
gjy	ぎゃい
gjw	ぎゅう
gjv	ぎゅう
gjl	ぎぇい
gjs	ぎぇい
gjh	ぎょう
gjx	ぎょう
gjc	
gjr	
gjj	
gj;	
gj'	
gya	ぎゃあ
gyi	ぎい
gyu	ぎゅう
gye	ぎぇい
gyo	ぎょう
gyn	ぎゃん
gyz	ぎゃん
gyg	ぎぃん
gyk	ぎぃん
gyb	ぎゅん
gyp	ぎゅん
gyd	ぎぇん
gyt	ぎぇん
gym	ぎょん
gyq	ぎょん
gyf	ぎゃい
gyy	ぎゃい
gyw	ぎゅう
gyv	ぎゅう
gyl	ぎぇい
gys	ぎぇい
gyh	ぎょう
gyx	ぎょう
gyc	
gyr	
gyj	
gy;	
gy'	
gha	がー
ghi	ぎー
ghu	ぐー
ghe	げー
gho	ごー
ghn	
ghz	
ghg	
ghk	
ghb	
ghp	
ghd	
ght	
ghm	
ghq	
ghf	
ghy	
ghw	
ghv	
ghl	
ghs	
ghh	
ghx	
ghc	
ghr	
ghj	
gh;	
gh'	
gwa	ぐぁ
gwi	ぐぃ
gwu	ぐぅ
gwe	ぐぇ
gwo	ぐぉ
gwn	ぐぁん
gwz	ぐぁん
gwg	ぐぃん
gwk	ぐぃん
gwb	ぐぅん
gwp	ぐぅん
gwd	ぐぇん
gwt	ぐぇん
gwm	ぐぉん
gwq	ぐぉん
gwf	ぐぁい
gwy	ぐぁい
gww	ぐぅう
gwv	ぐぅう
gwl	ぐぇい
gws	ぐぇい
gwh	ぐぉう
gwx	ぐぉう
gwc	
gwr	
gwj	
gw;	
gw'	
sa	さ
si	し
su	す
se	せ
so	そ
sn	さん
sz	さん
sg	しん
sk	しかし
sb	すん
sp	すん
sd	せん
st	し	t
sm	しま
sq	そん
sf	さい
sv	すう
sl	せい
ss	っ	s
sx	そう
sc	
sr	する
s;	それ
s'	
sja	しゃ
sji	し
sju	しゅ
sje	しぇ
sjo	しょ
sjn	しゃん
sjz	しゃん
sjg	しぃん
sjk	しぃん
sjb	しゅん
sjp	しゅん
sjd	しぇん
sjt	しぇん
sjm	しょん
sjq	しょん
sjf	しゃい
sjy	しゃい
sjw	しゅう
sjv	しゅう
sjl	しぇい
sjs	しぇい
sjh	しょう
sjx	しょう
sjc	
sjr	
sjj	
sj;	
sj'	
sya	しゃあ
syi	しい
syu	しゅう
sye	しぇい
syo	しょう
syn	しゃん
syz	しゃん
syg	しぃん
syk	しぃん
syb	しゅん
syp	しゅん
syd	しぇん
syt	しぇん
sym	しょん
syq	しょん
syf	しゃい
syy	しゃい
syw	しゅう
syv	しゅう
syl	しぇい
sys	しぇい
syh	しょう
syx	しょう
syc	
syr	
syj	
sy;	
sy'	
sha	しゃ
shi	し
shu	しゅ
she	しぇ
sho	しょ
shn	しゃん
shz	しゃん
shg	しぃん
shk	しぃん
shb	しゅん
shp	しゅん
shd	しぇん
sht	しぇん
shm	しょん
shq	しょん
shf	しゃい
shy	しゃい
shw	しゅう
shv	しゅう
shl	しぇい
shs	しぇい
shh	しょう
shx	しょう
shc	
shr	
shj	
sh;	
sh'	
swa	すぁ
swi	すぃ
swu	すぅ
swe	すぇ
swo	すぉ
swn	すぁん
swz	すぁん
swg	すぃん
swk	すぃん
swb	すぅん
swp	すぅん
swd	すぇん
swt	すぇん
swm	すぉん
swq	すぉん
swf	すぁい
swy	すぁい
sww	すぅう
swv	すぅう
swl	すぇい
sws	すぇい
swh	すぉう
swx	すぉう
swc	
swr	
swj	
sw;	
sw'	
xa	しゃ
xi	し
xu	しゅ
xe	しぇ
xo	しょ
xn	しゃん
xz	しゃん
xg	しん
xk	しん
xb	しゅん
xp	しゅん
xd	しぇん
xt	しぇん
xm	しょん
xq	しょん
xf	しゃい
xy	しゃい
xw	しゅう
xv	しゅう
xl	しぇい
xs	しぇい
xx	しょう
xc	
xr	
xj	
x;	
x'	
xha	しゃー
xhi	しー
xhu	しゅー
xhe	しぇー
xho	しょー
xhn	
xhz	
xhg	
xhk	
xhb	
xhp	
xhd	
xht	
xhm	
xhq	
xhf	
xhy	
xhw	
xhv	
xhl	
xhs	
xhh	
xhx	
xhc	
xhr	
xhj	
xh;	
xh'	
za	ざ
zi	じ
zu	ず
ze	ぜ
zo	ぞ
zn	ざん
zz	っ	z
zg	じん
zk	じん
zb	ずん
zp	ずん
zd	ぜん
zt	ぜん
zm	ぞん
zq	ぞん
zf	ざい
zv	ずう
zl	ぜい
zs	ぜい
zx	ぞう
zc	
zr	
z;	
z'	
zja	じゃ
zji	じ
zju	じゅ
zje	じぇ
zjo	じょ
zjn	じゃん
zjz	じゃん
zjg	じぃん
zjk	じぃん
zjb	じゅん
zjp	じゅん
zjd	じぇん
zjt	じぇん
zjm	じょん
zjq	じょん
zjf	じゃい
zjy	じゃい
zjw	じゅう
zjv	じゅう
zjl	じぇい
zjs	じぇい
zjh	じょう
zjx	じょう
zjc	
zjr	
zjj	
zj;	
zj'	
zya	じゃあ
zyi	じい
zyu	じゅう
zye	じぇい
zyo	じょう
zyn	じゃん
zyz	じゃん
zyg	じぃん
zyk	じぃん
zyb	じゅん
zyp	じゅん
zyd	じぇん
zyt	じぇん
zym	じょん
zyq	じょん
zyf	じゃい
zyy	じゃい
zyw	じゅう
zyv	じゅう
zyl	じぇい
zys	じぇい
zyh	じょう
zyx	じょう
zyc	
zyr	
zyj	
zy;	
zy'	
zha	ざー
zhi	じー
zhu	ずー
zhe	ぜー
zho	ぞー
zhn	
zhz	
zhg	
zhk	
zhb	
zhp	
zhd	
zht	
zhm	
zhq	
zhf	
zhy	
zhw	
zhv	
zhl	
zhs	
zhh	
zhx	
zhc	
zhr	
zhj	
zh;	
zh'	
zwa	ずぁ
zwi	ずぃ
zwu	ずぅ
zwe	ずぇ
zwo	ずぉ
zwn	ずぁん
zwz	ずぁん
zwg	ずぃん
zwk	ずぃん
zwb	ずぅん
zwp	ずぅん
zwd	ずぇん
zwt	ずぇん
zwm	ずぉん
zwq	ずぉん
zwf	ずぁい
zwy	ずぁい
zww	ずぅう
zwv	ずぅう
zwl	ずぇい
zws	ずぇい
zwh	ずぉう
zwx	ずぉう
zwc	
zwr	
zwj	
zw;	
zw'	
ja	じゃ
ji	じ
ju	じゅ
je	じぇ
jo	じょ
jn	じゃん
jz	じゃん
jg	じん
jk	じん
jb	じゅん
jp	じゅん
jd	じぇん
jt	じぇん
jm	じょん
jq	じょん
jf	じゃい
jy	じゃい
jw	じゅう
jv	じゅう
jl	じぇい
js	じぇい
jx	じょう
jc	
jr	
jj	っ	j
j;	
j'	
jha	じゃー
jhi	じー
jhu	じゅー
jhe	じぇー
jho	じょー
jhn	
jhz	
jhg	
jhk	
jhb	
jhp	
jhd	
jht	
jhm	
jhq	
jhf	
jhy	
jhw	
jhv	
jhl	
jhs	
jhh	
jhx	
jhc	
jhr	
jhj	
jh;	
jh'	
ta	た
ti	ち
tu	つ
te	て
to	と
tn	たん
tz	たん
tg	ちん
tb	つん
tp	つん
td	てん
tt	っ	t
tm	とん
tq	とん
tf	たい
tv	つう
tl	てい
tx	とう
tc	
tr	
t;	
t'	
tja	ちゃ
tji	ち
tju	ちゅ
tje	ちぇ
tjo	ちょ
tjn	ちゃん
tjz	ちゃん
tjg	ちぃん
tjk	ちぃん
tjb	ちゅん
tjp	ちゅん
tjd	ちぇん
tjt	ちぇん
tjm	ちょん
tjq	ちょん
tjf	ちゃい
tjy	ちゃい
tjw	ちゅう
tjv	ちゅう
tjl	ちぇい
tjs	ちぇい
tjh	ちょう
tjx	ちょう
tjc	
tjr	
tjj	
tj;	
tj'	
tya	ちゃあ
tyi	ちい
tyu	ちゅう
tye	ちぇい
tyo	ちょう
tyn	ちゃん
tyz	ちゃん
tyg	ちぃん
tyk	ちぃん
tyb	ちゅん
typ	ちゅん
tyd	ちぇん
tyt	ちぇん
tym	ちょん
tyq	ちょん
tyf	ちゃい
tyy	ちゃい
tyw	ちゅう
tyv	ちゅう
tyl	ちぇい
tys	ちぇい
tyh	ちょう
tyx	ちょう
tyc	
tyr	
tyj	
ty;	
ty'	
tha	てゃ
thi	てぃ
thu	てゅ
the	てぇ
tho	てょ
thn	てゃん
thz	てゃん
thg	てぃん
thk	てぃん
thb	てゅん
thp	てゅん
thd	てぇん
tht	てぇん
thm	てょん
thq	てょん
thf	てゃい
thy	てゃい
thw	てゅう
thv	てゅう
thl	てぇい
ths	てぇい
thh	てょう
thx	てょう
thc	
thr	
thj	
th;	
th'	
twa	とぁ
twi	とぃ
twu	とぅ
twe	とぇ
two	とぉ
twn	とぁん
twz	とぁん
twg	とぃん
twk	とぃん
twb	とぅん
twp	とぅん
twd	とぇん
twt	とぇん
twm	とぉん
twq	とぉん
twf	とぁい
twy	とぁい
tww	とぅう
twv	とぅう
twl	とぇい
tws	とぇい
twh	とぉう
twx	とぉう
twc	
twr	
twj	
tw;	
tw'	
tsa	つぁ
tsi	つぃ
tsu	つー
tse	つぇ
tso	つぉ
tsn	つぁん
tsz	つぁん
tsg	つぃん
tsk	つぃん
tsb	つん
tsp	つん
tsd	つぇん
tst	つぇん
tsm	つぉん
tsq	つぉん
tsf	つぁい
tsy	つぁい
tsw	つう
tsv	つう
tsl	つぇい
tss	つぇい
tsh	つぉう
tsx	つぉう
tsc	
tsr	
tsj	
ts;	
ts'	
tka	たー
tki	てぃー
tku	とぅー
tke	てー
tko	とー
tkn	
tkz	
tkg	
tkk	
tkb	
tkp	
tkd	
tkt	
tkm	
tkq	
tkf	
tky	
tkw	
tkv	
tkl	
tks	
tkh	
tkx	
tkc	
tkr	
tkj	
tk;	
tk'	
ca	ちゃ
ci	ち
cu	ちゅ
ce	ちぇ
co	ちょ
cn	ちゃん
cz	ちゃん
cg	ちん
ck	ちん
cb	ちゅん
cp	ちゅん
cd	ちぇん
ct	ちぇん
cm	ちょん
cq	ちょん
cf	ちゃい
cy	ちゃい
cw	ちゅう
cv	ちゅう
cl	ちぇい
cs	ちぇい
cx	ちょう
cc	っ	c
cr	
cj	
c;	
c'	
cha	ちゃ
chi	ちー
chu	ちゅ
che	ちぇ
cho	ちょ
chn	ちゃん
chz	ちゃん
chg	ちん
chk	ちん
chb	ちゅん
chp	ちゅん
chd	ちぇん
cht	ちぇん
chm	ちょん
chq	ちょん
chf	ちゃい
chy	ちゃい
chw	ちゅう
chv	ちゅう
chl	ちぇい
chs	ちぇい
chh	ちょう
chx	ちょう
chc	
chr	
chj	
ch;	
ch'	
da	だ
di	ぢ
du	づ
de	で
do	ど
dn	だん
dz	だん
dg	でぃん
db	どぅん
dp	どぅん
dd	っ	d
dt	でん
dm	どん
dq	どん
df	だい
dv	でゅう
dl	でい
dx	どう
dc	
dr	
d;	では
d'	
dja	ぢゃ
dji	ぢ
dju	ぢゅ
dje	ぢぇ
djo	ぢょ
djn	ぢゃん
djz	ぢゃん
djg	ぢぃん
djk	ぢぃん
djb	ぢゅん
djp	ぢゅん
djd	ぢぇん
djt	ぢぇん
djm	ぢょん
djq	ぢょん
djf	ぢゃい
djy	ぢゃい
djw	ぢゅう
djv	ぢゅう
djl	ぢぇい
djs	ぢぇい
djh	ぢょう
djx	ぢょう
djc	
djr	
djj	
dj;	
dj'	
dya	ぢゃあ
dyi	ぢい
dyu	ぢゅう
dye	ぢぇい
dyo	ぢょう
dyn	ぢゃん
dyz	ぢゃん
dyg	ぢぃん
dyk	ぢぃん
dyb	ぢゅん
dyp	ぢゅん
dyd	ぢぇん
dyt	ぢぇん
dym	ぢょん
dyq	ぢょん
dyf	ぢゃい
dyy	ぢゃい
dyw	ぢゅう
dyv	ぢゅう
dyl	ぢぇい
dys	ぢぇい
dyh	ぢょう
dyx	ぢょう
dyc	
dyr	
dyj	
dy;	
dy'	
dha	だー
dhi	でぃ
dhu	でゅ
dhe	でぇ
dho	でょ
dhn	
dhz	
dhg	
dhk	
dhb	
dhp	
dhd	
dht	
dhm	
dhq	
dhf	
dhy	
dhw	
dhv	
dhl	
dhs	
dhh	
dhx	
dhc	
dhr	
dhj	
dh;	
dh'	
dwa	どぁ
dwi	どぃ
dwu	どぅ
dwe	どぇ
dwo	どぉー
dwn	どぁん
dwz	どぁん
dwg	どぃん
dwk	どぃん
dwb	どぅん
dwp	どぅん
dwd	どぇん
dwt	どぇん
dwm	どぉん
dwq	どぉん
dwf	どぁい
dwy	どぁい
dww	どぅう
dwv	どぅう
dwl	どぇい
dws	どぇい
dwh	どぉう
dwx	どぉう
dwc	
dwr	
dwj	
dw;	
dw'	
dsa	づぁ
dsi	づぃ
dsu	づぅ
dse	づぇ
dso	づぉ
dsn	づぁん
dsz	づぁん
dsg	づぃん
dsk	づぃん
dsb	づぅん
dsp	づぅん
dsd	づぇん
dst	づぇん
dsm	づぉん
dsq	づぉん
dsf	づぁい
dsy	づぁい
dsw	づう
dsv	づう
dsl	づぇい
dss	づぇい
dsh	づぉう
dsx	づぉう
dsc	
dsr	
dsj	
ds;	です
ds'	
dka	だー
dki	でぃー
dku	どぉー
dke	でー
dko	どー
dkn	
dkz	
dkg	
dkk	
dkb	
dkp	
dkd	
dkt	
dkm	
dkq	
dkf	
dky	
dkw	
dkv	
dkl	
dks	
dkh	
dkx	
dkc	
dkr	だから
dkj	
dk;	
dk'	
na	な
ni	に
nu	ぬ
ne	ね
no	の
nn	ん
nz	なん
ng	にん
nk	にん
nb	ぬん
np	ぬん
nd	ので
nt	ねん
nm	のん
nq	のん
nf	ない
nw	ぬう
nv	ぬう
nl	ねい
ns	ねい
nx	のう
nc	
nr	な	r
n;	
n'	
nja	にゃ
nji	に
nju	にゅ
nje	にぇ
njo	にょ
njn	にゃん
njz	にゃん
njg	にぃん
njk	にぃん
njb	にゅん
njp	にゅん
njd	にぇん
njt	にぇん
njm	にょん
njq	にょん
njf	にゃい
njy	にゃい
njw	にゅう
njv	にゅう
njl	にぇい
njs	にぇい
njh	にょう
njx	にょう
njc	
njr	
njj	
nj;	
nj'	
nya	にゃあ
nyi	にい
nyu	にゅう
nye	にぇい
nyo	にょう
nyn	にゃん
nyz	にゃん
nyg	にぃん
nyk	にぃん
nyb	にゅん
nyp	にゅん
nyd	にぇん
nyt	にぇん
nym	にょん
nyq	にょん
nyf	にゃい
nyy	にゃい
nyw	にゅう
nyv	にゅう
nyl	にぇい
nys	にぇい
nyh	にょう
nyx	にょう
nyc	
nyr	
nyj	
ny;	
ny'	
nha	なー
nhi	にー
nhu	ぬー
nhe	ねー
nho	のー
nhn	
nhz	
nhg	
nhk	
nhb	
nhp	
nhd	
nht	
nhm	
nhq	
nhf	
nhy	
nhw	
nhv	
nhl	
nhs	
nhh	
nhx	
nhc	
nhr	
nhj	
nh;	
nh'	
ha	は
hi	ひ
hu	ふ
he	へ
ho	ほ
hn	はん
hz	はん
hg	ひん
hb	ひん
hp	ふん
hd	ふん
ht	へん
hm	ほん
hq	ほん
hf	はい
hv	ふう
hl	へい
hh	っ	h
hx	ほう
hc	
hr	
h;	;
h'	'
hja	ひゃ
hji	ひ
hju	ひゅ
hje	ひぇ
hjo	ひょ
hjn	ひゃん
hjz	ひゃん
hjg	ひぃん
hjk	ひぃん
hjb	ひゅん
hjp	ひゅん
hjd	ひぇん
hjt	ひぇん
hjm	ひょん
hjq	ひょん
hjf	ひゃい
hjy	ひゃい
hjw	ひゅう
hjv	ひゅう
hjl	ひぇい
hjs	ひぇい
hjh	ひょう
hjx	ひょう
hjc	
hjr	
hjj	
hj;	
hj'	
hya	ひゃあ
hyi	ひい
hyu	ひゅう
hye	ひぇい
hyo	ひょう
hyn	ひゃん
hyz	ひゃん
hyg	ひぃん
hyk	ひぃん
hyb	ひゅん
hyp	ひゅん
hyd	ひぇん
hyt	ひぇん
hym	ひょん
hyq	ひょん
hyf	ひゃい
hyy	ひゃい
hyw	ひゅう
hyv	ひゅう
hyl	ひぇい
hys	ひぇい
hyh	ひょう
hyx	ひょう
hyc	
hyr	
hyj	
hy;	
hy'	
hsa	さー
hsi	しー
hsu	すー
hse	せー
hso	そー
hsn	
hsz	
hsg	
hsk	
hsb	
hsp	
hsd	
hst	
hsm	
hsq	
hsf	
hsy	
hsw	
hsv	
hsl	
hss	
hsh	
hsx	
hsc	
hsr	
hsj	
hs;	
hs'	
hwa	ふぁ
hwi	ふぃ
hwu	ふ
hwe	ふぇ
hwo	ふぉ
hwn	ふぁん
hwz	ふぁん
hwg	ふぃん
hwk	ふぃん
hwb	ふぅん
hwp	ふぅん
hwd	ふぇん
hwt	ふぇん
hwm	ふぉん
hwq	ふぉん
hwf	ふぁい
hwy	ふぁい
hww	ふぅう
hwv	ふぅう
hwl	ふぇい
hws	ふぇい
hwh	ふぉう
hwx	ふぉう
hwc	
hwr	
hwj	
hw;	
hw'	
hka	はー
hki	ひー
hku	ふー
hke	へー
hko	ほー
hkn	
hkz	
hkg	
hkk	
hkb	
hkp	
hkd	
hkt	
hkm	
hkq	
hkf	
hky	
hkw	
hkv	
hkl	
hks	
hkh	
hkx	
hkc	
hkr	
hkj	
hk;	
hk'	
fa	ふぁ
fi	ふぃ
fu	ふ
fe	ふぇ
fo	ふぉ
fn	ふぁん
fz	ふぁん
fg	ふぃん
fk	ふぃん
fb	ふん
fp	ふん
fd	ふぇん
ft	ふぇん
fm	ふぉん
fq	ふぉん
ff	っ	f
fy	ふぁい
fw	ふう
fv	ふう
fl	ふぇい
fs	ふぇい
fx	ふぉう
fc	
fr	
fj	
f;	；
f'	
fha	ふぁー
fhi	ふぃー
fhu	ふー
fhe	ふぇー
fho	ふぉー
fhn	
fhz	
fhg	
fhk	
fhb	
fhp	
fhd	
fht	
fhm	
fhq	
fhf	
fhy	
fhw	
fhv	
fhl	
fhs	
fhh	
fhx	
fhc	
fhr	
fhj	
fh;	
fh'	
ba	ば
bi	び
bu	ぶ
be	べ
bo	ぼ
bn	ばん
bz	ばん
bg	びん
bk	びん
bb	っ	b
bp	ぶん
bd	べん
bt	べん
bm	ぼう
bq	ぼう
bf	ばい
bv	ぶう
bl	べい
bs	べい
bx	ぼう
bc	
br	
b;	
b'	
bja	びゃ
bji	び
bju	びゅ
bje	びぇ
bjo	びょ
bjn	びゃん
bjz	びゃん
bjg	びぃん
bjk	びぃん
bjb	びゅん
bjp	びゅん
bjd	びぇん
bjt	びぇん
bjm	びょう
bjq	びょう
bjf	びゃい
bjy	びゃい
bjw	びゅう
bjv	びゅう
bjl	びぇい
bjs	びぇい
bjh	びょう
bjx	びょう
bjc	
bjr	
bjj	
bj;	
bj'	
bya	びゃあ
byi	びい
byu	びゅう
bye	びぇい
byo	びょう
byn	びゃん
byz	びゃん
byg	びぃん
byk	びぃん
byb	びゅん
byp	びゅん
byd	びぇん
byt	びぇん
bym	びょう
byq	びょう
byf	びゃい
byy	びゃい
byw	びゅう
byv	びゅう
byl	びぇい
bys	びぇい
byh	びょう
byx	びょう
byc	
byr	
byj	
by;	
by'	
bha	ばー
bhi	びー
bhu	ぶー
bhe	べー
bho	ぼー
bhn	
bhz	
bhg	
bhk	
bhb	
bhp	
bhd	
bht	
bhm	
bhq	
bhf	
bhy	
bhw	
bhv	
bhl	
bhs	
bhh	
bhx	
bhc	
bhr	
bhj	
bh;	
bh'	
bwa	ぶぁ
bwi	ぶぃ
bwu	ぶぅ
bwe	ぶぇ
bwo	ぶぉ
bwn	ぶぁん
bwz	ぶぁん
bwg	ぶぃん
bwk	ぶぃん
bwb	ぶぅん
bwp	ぶぅん
bwd	ぶぇん
bwt	ぶぇん
bwm	ぶぉん
bwq	ぶぉん
bwf	ぶぁい
bwy	ぶぁい
bww	ぶぅう
bwv	ぶぅう
bwl	ぶぇい
bws	ぶぇい
bwh	ぶぉう
bwx	ぶぉう
bwc	
bwr	
bwj	
bw;	
bw'	
pa	ぱ
pi	ぴ
pu	ぷ
pe	ぺ
po	ぽ
pn	
pz	
pg	
pk	
pb	
pp	っ	p
pd	
pt	
pm	
pq	
pf	
pv	
pl	
ps	
px	
pc	
pr	
p;	
p'	
pha	ぱー
phi	ぴー
phu	ぷー
phe	ぺー
pho	ぽー
phn	
phz	
phg	
phk	
phb	
php	
phd	
pht	
phm	
phq	
phf	
phy	
phw	
phv	
phl	
phs	
phh	
phx	
phc	
phr	
phj	
ph;	
ph'	
pja	ぴゃ
pji	ぴ
pju	ぴゅ
pje	ぴぇ
pjo	ぴょ
pjn	ぴゃん
pjz	ぴゃん
pjg	ぴぃん
pjk	ぴぃん
pjb	ぴゅん
pjp	ぴゅん
pjd	ぴぇん
pjt	ぴぇん
pjm	ぴょん
pjq	ぴょん
pjf	ぴゃい
pjy	ぴゃい
pjw	ぴゅう
pjv	ぴゅう
pjl	ぴぇい
pjs	ぴぇい
pjh	ぴょう
pjx	ぴょう
pjc	
pjr	
pjj	
pj;	
pj'	
pya	ぴゃあ
pyi	ぴい
pyu	ぴゅう
pye	ぴぇい
pyo	ぴょう
pyn	ぴゃん
pyz	ぴゃん
pyg	ぴぃん
pyk	ぴぃん
pyb	ぴゅん
pyp	ぴゅん
pyd	ぴぇん
pyt	ぴぇん
pym	ぴょん
pyq	ぴょん
pyf	ぴゃい
pyy	ぴゃい
pyw	ぴゅう
pyv	ぴゅう
pyl	ぴぇい
pys	ぴぇい
pyh	ぴょう
pyx	ぴょう
pyc	
pyr	
pyj	
py;	
py'	
pwa	ぷぁ
pwi	ぷぃ
pwu	ぷぅ
pwe	ぷぇ
pwo	ぷぉ
pwn	ぷぁん
pwz	ぷぁん
pwg	ぷぃん
pwk	ぷぃん
pwb	ぷぅん
pwp	ぷぅん
pwd	ぷぇん
pwt	ぷぇん
pwm	ぷぉん
pwq	ぷぉん
pwf	ぷぁい
pwy	ぷぁい
pww	ぷう
pwv	ぷう
pwl	ぷぇい
pws	ぷぇい
pwh	ぷぉう
pwx	ぷぉう
pwc	
pwr	
pwj	
pw;	
pw'	
ma	ま
mi	み
mu	む
me	め
mo	も
mn	もの
mz	まん
mg	みん
mk	みん
mb	むん
mp	むん
md	ま	d
mt	めん
mm	ん
mq	もん
mf	まい
mw	むう
mv	むう
ml	めい
ms	ま	s
mx	もう
mc	
mr	
m;	
m'	
mja	みゃ
mji	み
mju	みゅ
mje	みぇ
mjo	みょ
mjn	みゃん
mjz	みゃん
mjg	みぃん
mjk	みぃん
mjb	みゅん
mjp	みゅん
mjd	みぇん
mjt	みぇん
mjm	みょん
mjq	みょん
mjf	みゃい
mjy	みゃい
mjw	みゅう
mjv	みゅう
mjl	みぇい
mjs	みぇい
mjh	みょう
mjx	みょう
mjc	
mjr	
mjj	
mj;	
mj'	
mya	みゃあ
myi	みい
myu	みゅう
mye	みぇい
myo	みょう
myn	みゃん
myz	みゃん
myg	みぃん
myk	みぃん
myb	みゅん
myp	みゅん
myd	みぇん
myt	みぇん
mym	みょん
myq	みょん
myf	みゃい
myy	みゃい
myw	みゅう
myv	みゅう
myl	みぇい
mys	みぇい
myh	みょう
myx	みょう
myc	
myr	
myj	
my;	
my'	
mha	まー
mhi	みー
mhu	むー
mhe	めー
mho	もー
mhn	
mhz	
mhg	
mhk	
mhb	
mhp	
mhd	
mht	
mhm	
mhq	
mhf	
mhy	
mhw	
mhv	
mhl	
mhs	
mhh	
mhx	
mhc	
mhr	
mhj	
mh;	
mh'	
ya	や
yi	い
yu	ゆ
ye	いぇ
yo	よ
yn	やん
yz	やん
yg	いん
yk	いん
yb	ゆん
yp	ゆん
yd	いぇん
yt	いぇん
ym	よん
yq	よん
yf	やい
yy	っ	y
yw	ゆう
yv	ゆう
yl	いぇい
ys	いぇい
yx	よう
yc	
yr	よ	r
y;	
y'	
yja	ゃ
yji	
yju	ゅ
yje	
yjo	ょ
yjn	
yjz	
yjg	
yjk	
yjb	
yjp	
yjd	
yjt	
yjm	
yjq	
yjf	
yjy	
yjw	
yjv	
yjl	
yjs	
yjh	
yjx	
yjc	
yjr	
yjj	
yj;	
yj'	
yha	やー
yhi	いー
yhu	ゆー
yhe	いぇー
yho	よー
yhn	
yhz	
yhg	
yhk	
yhb	
yhp	
yhd	
yht	
yhm	
yhq	
yhf	
yhy	
yhw	
yhv	
yhl	
yhs	
yhh	
yhx	
yhc	
yhr	
yhj	
yh;	
yh'	
ra	ら
ri	り
ru	る
re	れ
ro	ろ
rn	らん
rz	らん
rg	りん
rk	りん
rb	るん
rp	るん
rd	れん
rt	れん
rm	ろん
rq	ろん
rf	らい
rw	るう
rv	るう
rl	れい
rs	れい
rx	ろう
rc	
rr	っ	r
r;	
r'	
rja	りゃ
rji	り
rju	りゅ
rje	りぇ
rjo	りょ
rjn	りゃん
rjz	りゃん
rjg	りぃん
rjk	りぃん
rjb	りゅん
rjp	りゅん
rjd	りぇん
rjt	りぇん
rjm	りょん
rjq	りょん
rjf	りゃい
rjy	りゃい
rjw	りゅう
rjv	りゅう
rjl	りぇい
rjs	りぇい
rjh	りょう
rjx	りょう
rjc	
rjr	
rjj	
rj;	
rj'	
rya	りゃあ
ryi	りい
ryu	りゅう
rye	りぇい
ryo	りょう
ryn	りゃん
ryz	りゃん
ryg	りぃん
ryk	りぃん
ryb	りゅん
ryp	りゅん
ryd	りぇん
ryt	りぇん
rym	りょん
ryq	りょん
ryf	りゃい
ryy	りゃい
ryw	りゅう
ryv	りゅう
ryl	りぇい
rys	りぇい
ryh	りょう
ryx	りょう
ryc	
ryr	
ryj	
ry;	
ry'	
rha	らー
rhi	りー
rhu	るー
rhe	れー
rho	ろー
rhn	
rhz	
rhg	
rhk	
rhb	
rhp	
rhd	
rht	
rhm	
rhq	
rhf	
rhy	
rhw	
rhv	
rhl	
rhs	
rhh	
rhx	
rhc	
rhr	
rhj	
rh;	
rh'	
la	りゃ
li	り
lu	りゅ
le	りぇ
lo	りょ
ln	りゃん
lz	りゃん
lg	りぃん
lk	りぃん
lb	りゅん
lp	りゅん
ld	りぇん
lt	りぇん
lm	りょん
lq	りょん
lf	りゃい
ly	りゃい
lw	りゅう
lv	りゅう
ll	っ	l
ls	りぇい
lx	りょう
lc	
lr	
lj	
l;	
l'	
lha	りゃー
lhi	りー
lhu	りゅー
lhe	りぇー
lho	りょー
lhn	
lhz	
lhg	
lhk	
lhb	
lhp	
lhd	
lht	
lhm	
lhq	
lhf	
lhy	
lhw	
lhv	
lhl	
lhs	
lhh	
lhx	
lhc	
lhr	
lhj	
lh;	
lh'	
wa	わ
wi	うぃ
wu	う
we	うぇ
wo	を
wn	わん
wz	わん
wg	うぃん
wk	うぃん
wb	うん
wp	うん
wd	うぇん
wt	うぇん
wm	うぉん
wq	うぉん
wf	わい
ww	っ
wv	
wl	うぇい
ws	うぇい
wx	うぉう
wc	
wr	
wj	
w;	
w'	
wya	
wyi	ゐ
wyu	
wye	ゑ
wyo	
wyn	
wyz	
wyg	
wyk	
wyb	
wyp	
wyd	
wyt	
wym	
wyq	
wyf	
wyy	
wyw	
wyv	
wyl	
wys	
wyh	
wyx	
wyc	
wyr	
wyj	
wy;	
wy'	
wha	うぁ
whi	うぃ
whu	う
whe	うぇ
who	うぉ
whn	
whz	
whg	
whk	
whb	
whp	
whd	
wht	
whm	
whq	
whf	
why	
whw	
whv	
whl	
whs	
whh	
whx	
whc	
whr	
whj	
wh;	
wh'	
va	ぁ
vi	ぃ
vu	ぅ
ve	ぇ
vo	ぉ
vn	あん
vz	あん
vg	いん
vb	うん
vp	うん
vd	えん
vt	えん
vm	おん
vq	おん
vf	あい
vv	っ
vl	えい
vs	えい
vx	おう
vc	あり
vr	ある
v;	あれ
v'	
vja	ゃ
vji	
vju	ゅ
vje	
vjo	ょ
vjn	
vjz	
vjg	
vjk	
vjb	
vjp	
vjd	
vjt	
vjm	
vjq	
vjf	
vjy	
vjw	
vjv	
vjl	
vjs	
vjh	
vjx	
vjc	
vjr	
vjj	
vj;	
vj'	
vya	ヴゃ
vyi	ヴぃ
vyu	ヴゅ
vye	ヴぇ
vyo	ヴょ
vyn	ヴゃん
vyz	ヴゃん
vyg	ヴぃん
vyk	ヴぃん
vyb	ヴゅん
vyp	ヴゅん
vyd	ヴぇん
vyt	ヴぇん
vym	ヴょん
vyq	ヴょん
vyf	ヴゃー
vyy	ヴゃー
vyw	ヴゅー
vyv	ヴゅー
vyl	ヴぃー
vys	ヴぃー
vyh	ヴょー
vyx	ヴょー
vyc	
vyr	
vyj	
vy;	
vy'	
vha	ヴぁ
vhi	ヴぃ
vhu	ヴ
vhe	ヴぇ
vho	ヴぉ
vhn	ヴぁん
vhz	ヴぁん
vhg	ヴぃん
vhk	ヴぃん
vhb	ヴん
vhp	ヴん
vhd	ヴぇん
vht	ヴぇん
vhm	ヴぉん
vhq	ヴぉん
vhf	ヴぁー
vhy	ヴぁー
vhw	ヴー
vhv	ヴー
vhl	ヴぇー
vhs	ヴぇー
vhh	ヴぉー
vhx	ヴぉー
vhc	
vhr	
vhj	
vh;	
vh'	
vwa	ゎ
vwi	
vwu	
vwe	
vwo	
vwn	
vwz	
vwg	
vwk	
vwb	
vwp	
vwd	
vwt	
vwm	
vwq	
vwf	
vwy	
vww	
vwv	
vwl	
vws	
vwh	
vwx	
vwc	
vwr	
vwj	
vw;	
vw'	
vka	ヵ
vki	
vku	
vke	ヶ
vko	
vkn	
vkz	
vkg	
vkk	
vkb	
vkp	
vkd	
vkt	
vkm	
vkq	
vkf	
vky	
vkw	
vkv	
vkl	
vks	
vkh	
vkx	
vkc	
vkr	
vkj	
vk;	
vk'	
